xxxxxxxxxxxxxxxx
x   xxv ss  vv x
x   sss  ss vv x
xx   ss  vv    x
xx  s  xv x   xx
xx    xxs xv xsx
xx      xx   vsx
xx      xx xx xx
xx        vv ssx
xx    ss s     x
x             ex
xxxxxxxxxxxxxxxx
