xxxxxxxxxxxxxxxx
x   xxx       cx
x   sssxsss    x
x    ss        x
xxx    svx    xx
x     xxs    xsx
xx    xx     xsx
x   xx xx     xx
x   xvx     ss x
x            xxx
x ss          xx
xxxxxxxxxxxxxxxx
